[pl]
MAINMENU =  \yGlobal Offensive \w| \rDollar(y): \d%d\w$
INVENTORY = Ekwipunek
CASEOPEN = Otworz skrzynke
CASEOPENM = Otworz skrzynke^n\wKlucze: \y%d
TRADE = Wymiana
MARKET = Sklep
MMARKET = Glowne Menu Sklepu
TRASH = \rKosz na skiny
RANKMENU = ^n^n\rTwoja ranga:\d %s \w(\y%d\w/\y%d\w)^n\rNext:\d %s
RANKMENUMAX = ^n^n\rTwoja ranga:\d %s \wZabojstwa: \y%d
REGISTERMENU =  \yGlobal Offensive \w| \rSystem rejestracji
USERNAME = \rLogin:\d %s
USERNAME2 = \rLogin:\d %s^n\d2. Haslo:
PASSWORD = \rHaslo:\d %s
LOGIN = Login
REGISTER = \yRejestracja
SHORT = Za krotkie! (Min. 4 znaki)
LONG = Za dlugie! (Max. 19 znakow)
REGISTERED = Rejestracja udana!
REGDATAS = Login:!t %s!y | !yHaslo:!t %s
LOGINED = Logowanie udane!
LOGINPENDING = Trwa logowanie... Poczekaj chwile!
REGISTERPENDING = Trwa rejestracja... Poczekaj chwile!
USERUSING = Ktos uzywa juz tego loginu!
BADUSER = Nazwa uzytkownika lub haslo sa zle!
BADPW = Zle haslo!
USERNAMEUSING = Ktos uzywa juz tego loginu!
WPMENU1 = Karabiny
WPMENU2 = Pistolety
WPMESSAGE = Juz to uzyles!!
SVMESSAGE = Ten Serwer uzywa !g CSGO Mod !
TMMESSAGE = Oferta kupna / wymiany anulowana!
RANKNEWLV = Gratulacje! Jestes juz: !g%s
SELL = Sprzedaj
BUY = Kup
SELLI = Sprzedaj przedmiot
BUYI = Kup przedmiot
ITEM = Przedmiot:\d %s^n
SELLITEM = Przedmiot:\d %s\r |\w Cena:\d %d\r$ \r|\d by \w%s
CHOOSEITEM = Przedmiot :\d Wybierz cos
CHOOSESELLITEM = Cena przedmiotu:\d %d\r$^n
INMARKET = Przedmiot:\d %s\r |\w Cena:\d %d\r$\d (CANCEL)
TOMARKET = \yDodawanie do sklepu!
MARKETBUY = \yKup
MARKETMENUBUY = \wSklep \rDolar(y):\d %d$
LOWPRICE = Najnizsza cena:!g %d!y!
HIGHPRICE = Najwyzsza cena:!g %d!y!
BADPRICE = Wartosci pomiedzy !t%d!y i!t %d!y musi byc!
NOTENOUGHDOLLAR = Nie masz wystarczajaco pieniedzy!
ITEMISSOLD = Za pozno! Ktos kupil ten przedmiot przed toba!
BUYINGITEM = !t%s!y kupil!t %s!y za!g %d!y dolar(ow) od!t %s!y!
SOLVEDTOMARKET = !t%s!y wyslal!t %s!y do marketu za in!g %d!y dollar(ow)!
NOTENOUGHK = Niewystarczajaca ilosc kluczy!
NOTENOUGHC = Niewystarczajaca ilosc skrzynek!
SERVERLOADING = Server sie laduje...
UNBOXING = !t%s!y znalazl w skrzynce !g%s!y ! Gratulacje!
FOUND = !t%s!y znalazl !g%s!y !
WANTTRADE = \r%s\w chce sie wymienic!
WANTTRADE2 = !t%s!y chce sie wymienic!
DONTACCEPTEDTRADE = Ta wymiana nie zostala zaakceptowana! t!
TRADEITEMS = \d- \y%s \r \d-
TRADEDOLLAR = \wWymiana \rDollar(ow):\d %d$
TRADEACCEPT = \yAkceptuj!
TRADEREJECT = \rOdrzuc!
TRADEITEM = \y%s \r- \d(\wCzesci: \r%d\d)
TRADEDOLLAR2 = \rDollar(y): \d%d$^n
TRADENOTHING = \dNic
TRADECHOOSE = Wybierz przedmiot
TRADEYOURITEMS = \rDollar(y): \d%d$^n^n   \d - \yTwoje przedmioty \d-^n
SUCCESSTRADE = Wymiana udana!
MY_LOGIN = Login
MY_PASSWORD = Haslo
BUYSUCCESS = Pomyslnie zakupiono!
NOLOGON = Nie jestes zalogowany !
BADAMOUNT = Zla wartosc !
KEYSTORE = Kup Klucze
CASESTORE = Kup Skrzynki
NOTBETZERO = Nie Możesz Postawić Zera !
BETW = Wygrałeś - !g%u$
BETL = Przegrałeś - !t%u$
BETMENU = Ruletka | Bet: \r %d$
BET = Postaw
YOURBET = Wartosc Bet'a
BETS = Ruletka
BETMW = %s Postawił !g%u a !yWygrał !g%u !yGratulacje !
MINBET = Minimalny Bet to %d$!
MAXBET = Maxymalny Bet to %d$!
NOPREM = Nie Masz Dostępu Do Tej komendy !
ADMINMENU = \rMenu Admina
DEFVIPBONUS = Rozbrojiłeś bombę i posiadasz VIPa, Zostajesz nagrodzony !g%d!
DEFBONUS = Rozbrojiłeś bombę, Zostajesz nagrodzony !g%d!
BOMBVIPBONUS = Podłożyłeś bombę i posiadasz VIPa, Zostajesz nagrodzony !g%d!
BOMBBONUS = Podłożyłeś bombę, Zostajesz nagrodzony !g%d!